1 15 50
2 2 2 2 2 2 2 2 2 2 2 2 2 2 2 2 2 2 2 2 2 2 2 2 2 2 2 2 2 2 2 2 2 2 2 2 2 2 2 2 2 2 2 2 2 2 2 2 2 2
2 0 0 0 0 0 0 0 0 0 0 0 0 0 0 0 0 0 0 0 0 0 0 0 0 0 0 0 0 0 0 0 0 0 0 0 0 0 0 0 0 0 0 0 0 0 0 0 0 2
2 0 0 4 0 0 0 3 3 3 0 3 0 3 0 3 3 3 0 0 0 0 0 0 0 3 0 3 0 3 3 3 0 3 3 3 0 0 0 0 0 0 0 0 0 0 0 0 0 2
2 0 0 5 0 0 0 3 0 3 0 3 0 3 0 3 0 0 0 0 0 0 0 0 0 3 0 3 0 3 0 0 0 0 3 0 0 0 0 0 0 0 0 0 0 0 0 0 0 2
2 0 0 6 0 0 0 3 0 3 0 3 0 3 0 3 3 0 0 0 0 0 0 0 0 3 0 3 0 3 3 0 0 0 3 0 0 0 0 0 0 0 0 0 0 0 0 0 0 2
2 0 0 7 0 0 0 3 0 3 0 3 3 3 0 3 0 0 0 0 0 0 0 0 0 3 0 3 0 3 0 0 0 0 3 0 0 0 0 0 0 0 0 0 0 0 0 0 0 2
2 0 0 8 3 3 0 3 3 3 0 0 3 0 0 3 3 3 0 0 0 0 0 0 0 3 3 3 0 3 3 3 0 0 3 0 0 0 0 0 0 0 0 0 0 0 0 0 0 2
2 0 0 0 0 0 0 0 0 0 0 0 0 0 0 0 0 0 0 0 0 0 0 0 0 0 0 0 0 0 0 0 0 0 0 0 0 0 0 0 0 0 0 0 0 0 0 0 0 2
2 0 0 3 0 3 0 0 3 0 0 3 3 3 0 3 3 3 0 0 0 0 0 0 0 3 3 3 0 3 3 3 0 3 3 3 0 0 0 0 0 0 0 0 0 0 0 0 0 2
2 0 0 3 0 3 0 3 0 3 0 0 3 0 0 3 0 0 0 0 0 0 0 0 0 3 0 3 0 3 0 3 0 3 0 3 0 0 0 0 0 0 0 0 0 0 0 0 0 2
2 0 0 3 3 3 0 3 3 3 0 0 3 0 0 3 3 0 0 0 0 0 0 0 0 3 0 3 0 3 0 3 0 3 3 3 0 0 0 0 0 0 0 0 0 0 0 0 0 2
2 0 0 3 0 3 0 3 0 3 0 0 3 0 0 3 0 0 0 0 0 0 0 0 0 3 0 3 0 3 0 3 0 3 0 0 0 0 0 0 0 0 0 0 0 0 0 0 0 2
2 0 0 3 0 3 0 3 0 3 0 0 3 0 0 3 3 3 0 0 0 0 0 0 0 3 3 3 0 3 3 3 0 3 0 0 0 0 0 0 0 0 0 0 0 0 0 0 0 2
2 0 0 0 0 0 0 0 0 0 0 0 0 0 0 0 0 0 0 0 0 0 0 0 0 0 0 0 0 0 0 0 0 0 0 0 0 0 0 0 0 0 0 0 0 0 0 0 0 2
2 2 2 2 2 2 2 2 2 2 2 2 2 2 2 2 2 2 2 2 2 2 2 2 2 2 2 2 2 2 2 2 2 2 2 2 2 2 2 2 2 2 2 2 2 2 2 2 2 2