1 15 50
2 2 2 2 2 2 2 2 2 2 2 2 2 2 2 2 2 2 2 2 2 2 2 2 2 2 2 2 2 2 2 2 2 2 2 2 2 2 2 2 2 2 2 2 2 2 2 2 2 2
2 0 0 0 0 0 0 0 0 0 0 0 0 0 0 0 0 0 0 0 0 0 0 0 0 0 0 0 0 0 0 0 0 0 0 0 0 0 0 0 0 0 0 0 0 0 0 0 0 2
2 0 0 4 0 0 0 3 3 3 0 3 0 3 0 3 5 3 0 0 0 0 0 0 0 2 0 2 0 2 2 2 0 2 2 2 0 2 2 2 2 2 2 2 2 2 2 2 0 2
2 0 0 3 0 0 0 3 0 3 0 3 0 3 0 3 0 0 0 0 0 0 0 0 0 2 0 2 0 2 0 0 0 0 2 0 0 2 0 0 0 0 0 0 0 0 0 2 0 2
2 0 0 3 0 0 0 3 0 3 0 3 0 3 0 3 3 0 0 0 0 0 0 0 0 2 0 2 0 2 2 0 0 0 2 0 0 2 0 2 2 2 2 3 2 2 0 2 0 2
2 0 0 3 0 0 0 3 0 3 0 3 3 3 0 3 0 0 0 0 0 0 0 0 0 2 0 2 0 2 0 0 0 0 2 0 0 2 0 2 0 0 0 0 0 2 0 2 0 2
2 0 0 3 5 3 0 3 3 3 0 0 3 0 0 3 4 3 0 0 0 0 0 0 0 2 2 2 0 2 2 2 0 0 2 0 0 2 0 2 0 2 2 2 0 2 0 2 0 2
2 0 0 0 0 0 0 0 0 0 0 0 0 0 0 0 0 0 0 0 0 0 0 0 0 0 0 0 0 0 0 0 0 0 0 0 0 2 0 2 0 2 0 2 0 2 0 2 0 2
2 0 0 2 0 2 0 0 2 0 0 2 2 2 0 2 2 2 0 0 0 0 0 0 0 3 5 3 0 3 3 3 0 3 3 3 0 2 0 2 0 2 3 2 0 2 0 2 0 2
2 0 0 2 0 2 0 2 0 2 0 0 2 0 0 2 0 0 0 0 0 0 0 0 0 3 0 3 0 3 0 3 0 3 0 6 0 2 0 2 0 0 0 0 0 2 0 2 0 2
2 0 0 2 2 2 0 2 2 2 0 0 2 0 0 2 2 0 0 0 0 0 0 0 0 3 0 3 0 3 0 3 0 3 3 3 0 2 0 2 2 2 2 2 2 2 0 2 0 2
2 0 0 2 0 2 0 2 0 2 0 0 2 0 0 2 0 0 0 0 0 0 0 0 0 3 0 3 0 3 0 3 0 3 0 0 0 2 0 0 0 0 0 0 0 0 0 2 0 2
2 0 0 2 0 2 0 2 0 2 0 0 2 0 0 2 2 2 0 0 0 0 0 0 0 3 3 3 0 3 3 3 0 4 0 0 0 2 2 2 2 2 2 2 3 2 2 2 0 2
2 0 0 0 0 0 0 0 0 0 0 0 0 0 0 0 0 0 0 0 0 0 0 0 0 0 0 0 0 0 0 0 0 0 0 0 0 0 0 0 0 0 0 0 0 0 0 0 0 2
2 2 2 2 2 2 2 2 2 2 2 2 2 2 2 2 2 2 2 2 2 2 2 2 2 2 2 2 2 2 2 2 2 2 2 2 2 2 2 2 2 2 2 2 2 2 2 2 2 2